--- --- --- --- ROO RP4 ROO RD7 --- ---
--- --- --- --- --- --- --- --- --- ---
--- --- --- ST7 --- --- RT1 --- --- ---
RT1 ST5 --- --- ST3 RD7 --- --- RT3 ST7
RT3 ST7 --- --- SD7 RT7 --- --- RT1 ST5
--- --- --- ST5 --- --- RT3 --- --- ---
--- --- --- --- --- --- --- --- --- ---
--- --- SD7 SOO SP0 SOO --- --- --- ---