--- --- --- --- RT5 ROO RT3 --- --- ---
--- --- --- --- --- RP4 --- --- --- ---
RT1 --- --- --- RT5 ROO RD7 --- --- ---
RT3 --- RD1 --- ST7 --- ST3 --- --- ---
--- --- --- RT7 --- RT3 --- SD1 --- ST7
--- --- --- SD7 SOO ST1 --- --- --- ST5
--- --- --- --- SP0 --- --- --- --- ---
--- --- --- ST7 SOO ST1 --- --- --- ---