--- --- --- --- ROO RP4 ROO RT3 --- ---
--- --- RT5 --- --- --- --- --- --- ---
--- --- --- ST7 --- --- --- --- --- ---
RT1 --- ST5 --- RD1 RD7 --- RT3 --- ST7
RT3 --- ST7 --- SD7 SD1 --- RT1 --- ST5
--- --- --- --- --- --- RT3 --- --- ---
--- --- --- --- --- --- --- ST1 --- ---
--- --- ST7 SOO SP0 SOO --- --- --- ---